11111111111111111111111111111111111111
10000000000000000000000000000011111111
10000001000000000000000000000000000001
10000001001111111111111111111000100001
1000C001001000000000000100001000100001
10011111001000000000000100001C00100001
10000001001000000001000110011111100001
100000010010010000010C0100000000000001
10010001001001000001111100001000100001
1001000111111100P00001000001C101C10001
10010000000000000000010000100000001001
10011111111111000000000000100000001001
10000001000000000000000000010000010001
100000C1000000000001001100001000100001
100111110001000000100100100001E1000001
1001000001110000010000C100000010000001
10000111110000001111001000000000010001
10011101C11100000001011110000000111001
10000000000000000000000000000000010001
11111111111111111111111111111111111111