1111111111111111111111111111111111111
1000000000000000000000000000001111111
1000000100000000000000000000000000001
1000000100111111111111111111100010001
1000C00100100000000000010000100010001
10011111001000000000000100001C0010001
1000000100100000000100011001111110001
100000010010010000010C010000000000001
1001000100100100000111110000100010001
1001000111111100P00001000001C101C1001
1001000000000000000001000010000000101
1001111111111100000000000010000000101
1000000100000000000000000001000001001
100000C100000000000100110000100010001
100111110001000000100100100001E100001
1001000001110000010000C10000001000001
1000011111000000111100100000000001001
10011101C1110000000101111000000011101
1000000000000000000000000000000001001
1111111111111111111111111111111111111