1111111111111111111
1E00100010C01111111
1110101010100100001
1C10001000110101101
10111100101100C1001
1000000110111101011
1110110000010001011
1010110111011100011
1111110111111101111
1C00000000C000000P1
1111111111111111111