1111111111111111111111111111
1C100P0010001000100000111001
1011101110100010001110101011
1000000000101111101C10100001
111111011C0000000010000001C1
1010000010111011110010010011
1000101000100000100100101011
1011101110000100001110C10011
100C101000100C00100010111011
1011000010111011111000000001
1010011010111010001011101101
10001E1000010000100000000001
1110101011110111111011111011
1000001000000C1C0000001000C1
1111111111111111111111111111