1111111111111111111111111111
1C100P0010000000000000000001
1011101110000000000000000001
1000000000000000000000000001
1111110110000000000000000001
1000000000111011100000000001
1000000000100000100000000001
1011101110000100000000000001
1000000000100000100000000001
1000000000111011100000000001
1000000000000000000000000001
1000000000000000000000000001
1000000000000000000000000001
1000000000000000000000000001
1111111111111111111111111111