1111111111111111111111111111
1000000000001001000000000001
1000000000010010100000000001
10000000001110C1000000000001
1000000000001011100000000001
1000000000000000000000000001
1011110011111001111101111001
1010E10010000000001001000001
1010010010000111001001100111
1000010000000111000001C00001
1000000000000000000001111001
10011000100000000C1000000001
1001100011111000111110011111
1000000000001000000P000000C1
1111111111111111111111111111