1111111111111111111
1000000000000000C11
100C11100001E100111
1001110000011100011
1000000000000000001
1101111011110010001
1000001000P0001C001
1111111000110011101
10100C0000110000001
1111111111111111111