1111111111111111111
1000000000000000C11
100C11100001E100111
1001110000011100011
1000000000000000001
1101111011110010001
10000P100000001C001
1101111000110011101
10000C0000110000001
1111111111111111111