1111111111111111111
1000000000000011111
10C00C0000000000001
1111111100000000001
1000000000100000001
1000000000111000001
10001000000P0000001
1001110000000C11111
1000100000000000001
10000C00000100000E1
1111111111111111111