111111111111111111111111111111111111111
100000000000000000000000000000111111111
100000010000000000000000000000000000001
100000010011111111111111111110001000001
1000C0010010000000000001000010001000001
10011111001000000000000100001C001000001
100000010010000000010001100111111000001
100000010010010000010C01000000000000001
100100010010010000011111000010001000001
1001000111111100P00001000001C101C100001
100100000000000000000100001000000010001
100111111111110000000000001000000010001
100000010000000000000000000100000100001
100000C10000000000010011000010001000001
100111110001000000100100100001E10000001
1001000001110000010000C1000000100000001
100001111100000011110010000000000100001
10011101C111000000010111100000001110001
100000000000000000000000000000000100001
100001111100000011110010000000000100001
10011101C111000000010111100000001110001
100000000000000000000000000000000100001
111111111111111111111111111111111111111