NO ./utils/textures/NO
.xpm
SO ./utils/textures/SO.xpm
WE ./utils/textures/WE
.xpm
EA ./utils/textures/EA
.xpm

F 143, 118, 109
C 65, 73, 74


111111111111111111111111111111
1S1111111111111110000000000111
101111111111111110111111110111
100000000111111110111111110111
111111110000000000111111110111
111111111111111111111111110111
111111110000000000000000000111
111111110111111111111111111111
110000000000000111111111111111
111111111111110111111111111111
111111111111110000011111111111
111110111111111111000000000011
111110111111000001111111111011
111110111111011100000000000011
111110000000011111111111111111
111111111111111111111111111111
