NO ./utils/textures/NO.xpm
SO ./utils/textures/SO.xpm
WE ./utils/textures/WE.xpm
EA ./utils/textures/EA.xpm

F 143, 118, 109
C 58, 64, 66


 111111111111111111111111111111111111111
110000000000001000000000000000E0000000001
 101111111111010111111111011111111011111
 101        10001       101      101
1101111111111000111111110001    10001
1000000000000000000000000001    10001
1000011000000000000000110001   1000001
1000000000000000000000000001  100000001
100000000000001100000000000111100011101
10000000000000000000000000010000011 101
100001100000000000000011000001110111001
100000000000000000000000000101100000001
111111111111111111111111111101100000001
                           101110000001
                           101110001001
                           100000110001
                            1110111101
                      1111111110001111
                   11100000000000001
                     11111111111001
                                11